1 R 1 0 1
2 B 1 0 0
3 V 0 0 3
4 B 0 3 1
5 B 0 5 0
6 V 1 1 5